2 0 0 2 2 2 2 2 2 2 2 2 2 2 2 2 
2 0 0 0 0 0 0 0 0 0 0 0 0 0 0 2 
2 0 0 1 0 0 0 0 0 1 0 0 1 0 0 2 
2 0 0 0 0 0 1 0 0 0 0 0 0 1 0 2 
2 0 0 0 1 0 0 0 0 0 0 1 0 0 0 2 
2 0 0 0 0 0 0 0 0 0 3 3 3 0 0 2 
2 0 1 0 0 0 0 0 0 3 3 4 3 3 0 2 
2 0 0 0 0 0 0 0 0 4 3 3 5 3 0 2 
2 0 0 0 0 1 0 0 3 5 3 4 3 3 0 2 
2 1 0 0 0 0 0 3 3 3 4 3 3 0 0 2 
2 0 0 0 0 0 0 0 0 0 0 0 0 0 0 2 
2 2 2 2 2 2 2 2 2 2 2 2 2 2 2 2 