3 3 3 3 3 3 5 3 4 5 3 3 5 3 4 4 4 3 3 3 3 4 3 3 3 3 4 3 5 3 3 4 3 4 4 3 3 3 3 5 4 3 4 3 3 4 5 5 3 3 
3 3 3 3 3 3 5 5 3 5 5 3 5 4 4 4 4 3 3 3 4 3 5 5 3 4 4 5 3 5 3 3 5 3 5 3 3 3 3 3 3 4 4 5 5 5 4 4 3 3 
3 4 8 8 8 8 8 8 8 8 8 8 8 8 8 8 8 8 8 8 8 8 8 8 8 8 8 8 8 8 8 8 8 8 8 8 8 8 8 8 8 8 8 8 8 8 8 8 3 3 
3 3 8 8 8 8 8 8 8 8 8 8 8 8 8 8 8 8 8 8 8 8 8 8 8 8 8 8 8 8 8 8 8 8 8 8 8 8 8 8 8 8 8 8 8 8 8 8 3 5 
3 3 8 8 0 0 0 0 9 0 0 0 0 0 0 0 1 0 0 1 1 0 0 1 0 0 0 1 1 1 1 1 8 2 2 2 2 2 2 2 2 2 2 2 2 2 8 8 4 3 
5 3 8 8 1 0 0 0 10 9 10 1 0 1 0 1 1 0 0 1 1 0 0 1 1 1 9 10 9 0 0 1 8 2 17 17 17 17 17 17 17 17 17 17 17 2 8 8 3 3 
3 4 8 8 0 1 9 9 10 9 11 9 0 1 1 0 1 0 0 1 0 1 0 9 9 11 10 9 11 11 0 1 8 2 17 7 7 7 7 7 7 7 7 7 18 2 8 8 5 4 
3 5 8 8 1 9 10 10 9 9 9 10 11 1 0 1 0 0 0 0 9 9 11 9 9 9 11 9 9 9 9 0 8 2 17 7 7 7 7 7 7 7 7 7 18 2 8 8 3 3 
4 5 8 8 0 11 9 9 9 10 11 9 11 9 0 1 1 0 1 9 9 9 9 9 9 9 10 9 11 9 9 9 8 2 17 7 7 7 7 7 7 7 7 7 18 2 8 8 5 5 
3 3 8 8 9 11 11 10 11 10 11 10 10 9 9 9 0 1 9 9 6 6 6 6 6 6 6 6 6 9 9 11 7 2 17 16 22 7 7 16 18 18 18 18 18 2 8 8 3 3 
3 4 8 8 11 9 11 11 9 11 9 9 11 9 11 9 9 0 9 11 6 4 5 3 4 3 3 6 6 0 9 9 7 2 2 2 7 7 7 2 2 2 2 2 2 2 8 8 3 3 
3 3 8 8 9 9 11 9 11 9 10 9 10 11 10 9 11 9 9 10 6 3 4 3 3 8 8 8 8 8 8 7 7 7 8 8 8 8 8 8 8 8 8 8 8 8 8 8 3 4 
3 3 8 8 1 10 10 9 9 11 9 10 11 0 0 9 9 10 10 9 6 3 4 3 3 8 6 6 6 9 9 9 9 10 9 9 11 9 11 9 9 9 11 11 11 9 8 8 3 5 
3 5 8 8 1 0 0 0 1 0 11 11 9 0 0 0 9 9 9 11 6 6 6 8 8 8 6 1 9 11 9 11 9 9 9 10 10 10 11 11 9 10 9 10 10 10 8 8 3 3 
3 3 8 8 8 8 8 8 8 0 1 9 1 1 0 1 9 11 9 7 7 7 6 8 20 6 6 9 10 9 9 11 9 9 9 9 9 11 9 11 9 9 9 9 9 9 8 8 3 5 
3 3 8 8 8 8 8 8 8 8 1 0 1 0 0 0 0 1 1 7 9 9 12 8 12 9 9 9 11 9 11 10 10 10 9 9 9 11 9 11 9 9 10 9 11 10 8 8 3 3 
5 3 8 8 1 0 0 1 0 1 1 0 9 10 11 10 9 0 9 9 9 10 9 8 9 9 10 9 11 10 10 9 9 10 9 10 9 10 11 11 11 11 9 11 9 9 8 8 4 4 
4 5 8 8 1 1 1 1 1 1 0 0 10 9 11 11 11 0 11 11 9 9 11 8 10 9 9 10 10 11 9 10 10 9 9 9 10 9 10 9 9 9 9 9 9 9 8 8 3 5 
3 3 8 8 10 9 9 11 9 9 9 10 9 10 9 10 11 0 9 10 9 10 9 8 9 11 9 10 9 9 9 9 9 10 11 11 11 9 10 9 9 9 10 9 9 11 8 8 5 4 
5 4 8 8 9 9 11 9 11 11 10 11 10 10 1 0 1 1 11 9 10 9 11 8 11 9 11 9 11 11 10 9 9 9 10 9 10 6 6 6 6 6 6 10 11 9 8 8 3 5 
4 3 8 8 8 11 11 9 9 9 11 10 9 9 0 11 10 9 9 9 9 9 9 8 9 9 11 9 9 9 9 11 11 11 9 9 9 6 10 3 5 10 6 9 9 9 8 8 4 3 
3 3 8 8 7 7 7 7 9 9 9 9 9 11 0 9 9 11 11 11 9 10 6 8 6 9 9 9 10 9 9 11 9 9 9 9 9 6 10 3 4 10 6 9 9 10 8 8 3 4 
4 5 8 8 11 0 0 7 7 7 9 9 11 9 0 9 9 9 9 10 9 6 8 8 8 6 9 10 10 10 11 10 10 9 10 9 9 6 1 1 1 1 6 11 9 9 8 8 3 5 
3 3 8 8 9 11 1 0 0 7 7 7 7 8 8 8 8 8 8 8 8 8 8 8 8 8 8 8 8 8 8 8 8 9 11 9 11 6 1 1 1 1 6 9 9 11 8 8 3 4 
3 3 8 8 9 10 9 0 1 1 0 1 0 11 10 11 9 9 10 9 9 6 8 8 8 6 11 9 9 9 0 11 8 9 9 9 9 6 11 11 11 11 6 9 9 10 8 8 5 4 
5 3 8 8 9 10 10 9 11 0 0 1 1 0 1 0 11 11 9 9 10 10 6 8 6 9 9 10 10 0 1 9 8 11 9 11 9 6 11 11 11 11 6 10 9 9 8 8 3 3 
3 3 8 8 9 9 11 9 9 9 11 0 1 1 0 1 1 0 1 11 9 10 10 8 10 10 9 9 10 0 0 9 8 9 9 9 11 6 15 19 19 19 6 9 9 9 8 8 3 3 
5 3 8 8 9 9 9 9 9 9 11 9 9 0 0 1 1 1 1 1 9 9 9 8 9 11 10 9 10 0 9 11 8 8 8 8 8 6 29 19 19 19 6 11 9 11 8 8 5 5 
5 3 8 8 9 9 11 9 11 9 9 10 11 9 9 1 1 0 1 0 0 9 9 8 10 9 9 9 9 1 10 9 9 9 11 11 11 6 15 19 19 19 6 11 10 9 8 8 3 4 
3 3 8 8 9 9 11 9 1 1 9 9 9 11 11 11 7 7 7 0 1 9 9 8 9 11 9 10 9 0 9 11 9 9 11 10 11 6 19 19 19 19 6 10 11 11 8 8 3 3 
3 3 8 8 11 11 9 9 1 1 18 17 9 9 9 11 14 7 7 7 14 9 11 8 11 9 9 9 10 0 9 9 10 10 9 9 9 6 6 6 6 6 6 8 8 8 8 8 3 3 
3 3 8 8 9 10 9 9 1 1 18 18 21 13 9 10 9 10 7 7 9 11 9 8 9 11 10 9 9 0 9 9 9 10 11 9 9 10 10 10 9 10 9 9 11 9 8 8 3 3 
3 5 8 8 9 11 9 1 8 8 8 8 8 8 8 8 8 8 8 8 8 8 8 8 11 9 9 9 9 1 9 9 10 9 9 9 11 9 9 11 9 9 9 10 9 9 8 8 5 3 
5 3 8 8 10 9 9 1 8 1 17 18 17 13 9 8 9 9 11 9 11 9 10 9 9 9 11 9 10 0 10 9 11 9 10 9 9 9 9 11 10 9 9 9 9 9 8 8 3 5 
3 3 8 8 8 8 8 8 8 1 17 18 10 9 10 8 9 9 11 11 9 9 9 9 11 9 9 9 9 0 9 9 10 9 10 10 9 10 9 11 9 10 9 11 10 9 8 8 3 3 
5 3 8 8 11 9 11 10 1 18 10 11 10 11 9 8 10 9 9 9 10 10 9 10 9 10 10 9 9 0 10 10 11 9 9 9 10 9 9 9 9 9 9 9 9 9 8 8 5 4 
3 5 8 8 9 9 9 11 9 9 9 10 9 9 10 8 10 11 11 10 9 9 11 9 9 11 11 9 9 0 9 9 11 9 11 9 9 9 9 11 9 9 9 9 9 9 8 8 3 3 
3 3 8 8 11 10 9 11 9 9 9 9 11 11 10 8 9 9 11 10 9 9 9 9 10 9 9 11 9 0 10 11 10 9 9 9 9 9 10 10 9 11 10 11 9 9 8 8 3 3 
5 5 8 8 10 11 9 9 9 9 9 11 10 10 9 8 10 9 10 10 10 10 9 10 2 2 2 2 2 7 2 2 11 10 10 9 11 9 9 9 9 9 11 11 9 9 8 8 5 5 
4 3 8 8 9 9 11 9 9 8 8 23 23 23 24 8 10 9 9 9 10 11 9 9 2 7 7 7 7 7 7 2 9 9 11 10 9 9 9 9 9 9 9 10 9 9 8 8 3 3 
3 3 8 8 8 8 8 8 8 8 6 6 23 23 27 8 11 11 11 11 9 9 9 11 2 7 7 7 7 7 7 2 10 9 9 9 9 9 9 11 9 9 9 9 10 9 8 8 3 4 
3 3 8 8 11 11 9 9 8 6 6 6 6 6 6 8 9 9 11 11 9 9 11 11 2 2 2 2 2 2 2 2 9 11 11 9 9 10 9 9 10 10 9 11 9 9 8 8 3 4 
4 3 8 8 9 10 11 9 9 11 9 23 23 23 23 8 9 10 9 9 9 11 11 11 9 9 9 10 10 10 9 9 9 9 11 9 9 11 9 9 9 9 10 11 9 11 8 8 4 3 
5 3 8 8 9 10 10 9 9 11 9 9 10 10 9 8 9 11 9 9 9 9 9 10 9 9 9 9 9 9 9 9 10 9 9 10 9 9 9 9 11 9 9 11 9 9 8 8 3 3 
5 5 8 8 9 9 11 10 11 9 9 9 9 9 9 8 9 9 9 11 9 9 9 9 9 9 11 10 9 10 10 9 10 11 9 9 9 10 11 9 10 10 10 9 9 11 8 8 3 4 
4 3 8 8 2 2 2 2 2 2 2 19 19 1 1 8 11 9 10 9 11 9 9 10 11 9 9 11 10 11 9 11 9 9 9 9 9 10 11 11 11 9 10 9 10 9 8 8 3 4 
3 4 8 8 2 7 17 17 17 17 2 19 19 1 1 8 9 9 10 10 9 10 9 9 9 9 9 9 9 9 10 9 9 9 9 9 11 10 9 9 9 11 9 11 9 9 8 8 3 3 
3 3 8 8 7 7 7 7 7 17 2 10 19 1 1 8 11 11 9 10 9 9 9 10 9 9 9 9 9 9 9 9 9 9 11 10 9 10 9 9 9 9 9 9 9 10 8 8 3 3 
3 5 8 8 7 7 7 7 7 17 2 10 19 1 1 8 9 10 11 9 9 9 9 9 9 11 9 9 9 9 9 9 10 9 9 9 9 9 9 11 10 9 9 9 9 9 8 8 3 3 
3 3 8 8 2 7 7 7 7 7 7 7 7 7 7 8 31 32 11 9 9 11 9 9 9 9 9 9 9 10 11 9 9 9 9 10 10 9 10 9 9 9 9 11 9 9 8 8 3 3 
3 3 8 8 2 7 7 7 7 7 7 7 7 7 26 8 7 7 7 7 7 7 7 7 7 7 7 7 7 7 7 7 7 9 9 11 11 9 10 9 9 10 9 11 9 9 8 8 3 3 
3 3 8 8 2 18 7 7 28 7 2 11 19 1 25 8 9 9 9 9 7 0 0 0 0 0 6 11 9 9 10 10 11 9 10 9 9 9 9 9 10 9 10 9 9 9 8 8 3 3 
3 3 8 8 2 18 7 7 7 7 2 11 19 1 1 8 9 9 9 10 7 0 0 0 0 0 6 9 9 9 9 9 9 9 9 11 9 9 11 9 9 9 9 9 9 9 8 8 3 3 
3 3 8 8 2 18 18 18 18 18 2 19 19 1 1 8 9 9 9 9 7 0 0 0 0 0 6 9 9 11 9 9 9 9 9 10 9 11 9 9 9 9 9 9 9 11 8 8 4 3 
3 3 8 8 2 2 2 2 2 2 2 19 19 1 1 8 9 9 10 11 7 0 0 0 0 0 6 9 10 11 10 9 9 10 9 9 9 9 9 9 9 9 9 11 9 9 8 8 5 3 
3 5 8 8 9 9 9 9 10 10 10 9 10 9 10 8 9 9 9 9 7 0 0 0 0 0 6 9 9 9 11 9 9 9 9 9 9 9 9 11 9 9 9 9 9 9 8 8 3 3 
3 3 8 8 8 8 8 8 8 8 8 8 8 8 8 8 8 8 8 8 8 8 8 8 8 8 8 8 8 8 8 8 8 8 8 8 8 8 8 8 8 8 8 8 8 8 8 8 4 3 
3 30 8 8 8 8 8 8 8 8 8 8 8 8 8 8 8 8 8 8 8 8 8 8 8 8 8 8 8 8 8 8 8 8 8 8 8 8 8 8 8 8 8 8 8 8 8 8 30 3 
5 30 3 3 4 3 3 4 3 3 3 3 4 4 3 3 3 4 3 3 4 3 5 5 3 4 3 4 4 4 4 4 5 4 3 3 5 3 5 3 4 4 4 3 3 3 5 5 30 3 
4 4 3 3 4 5 5 4 5 3 3 3 4 3 3 4 3 5 4 5 4 4 4 4 3 3 3 3 3 3 4 3 3 3 5 3 3 3 4 5 3 5 4 4 3 4 5 5 3 3 
